%%%%%%%%%%%%%%%%%%%
%%%%%%%%%%%%%%%%%%%
%%.   .         .%%
%%      .        %%
%% %G%%%%%      .%%
%% P     %.      %%
%%.      %       %%
%%       %.     .%%
%%%%%%%%%%%%%%%%%%%
%%%%%%%%%%%%%%%%%%%
